W W W W W W W W W W W W W W W W W W W W W
W X X X X X X X X X X X X X X X X X X P W
W X W W W W W W W W W W X W W W W W W W W
W X X X X X X X X X X X X X X X E X X X W
W W W X W X W W W X W W X W W W W X W W W
W X X X X X X E X X X X X X X X X X X X W
W W W W W X W W W X W W X W W W W X W W W
W G X X X X X X X X X X X X X E X X X X W
W W W W W W W W W W W W W W W W W W W W W